111111111111111111111
120000000000000100001
100000000000000100001
100000000000000100001
100000000000000100001
100000000000000100001
100000000000000100001
100111111111111100001
100000000000000000001
100000000000000000001
100000000000000000031
111111111111111111111