1111111111111111111111111111111111111111111111111111111111111111111111111111111111111111111111111111111111111111111111111
1200000000000100000000000000000000000000000000000000000000000000000000000000000000000000000000000000000000000000000000001
1000000000000100000000000000000000000000000000000000000000000000000000000000000000000000000000000000000000000000000000001
1000000000000100000000000000000000000000000000000000000000000000000100000000000000000000000000000000000000000000000000001
1000000000000100000000000000000000000000000000000000000000000000000100000000000000000000000000000000000000000000000000001
1000000000000100000000000000000001000000000000000000000000000000000100000000000000000000000000000000000000000000000000001
1000000000000100000000000000000001000000000000000000000000000000000100000000000000000000000000000000000000000000000000001
1000000000000100000000000000000001000000000000000000000000000000000100000000000000000000000000000000000000000000000000001
1000000000000100000000000000000001000000000000000000000000000000000100000000000000000000100000000000000000000000000000001
1000000000000100000000000000000001000001111111111111111111111111111100000000000000000000100000000000000000000000000000001
1000000000000100000000000000000001000000000000000000000001000010000100000000000000000000100000000000000000000000000000001
1000000000000100000000000000000001000000000000000000000001000000000100000000000000000000100000000000000000000000000000001
1000000000000100000000000000000001111111111111111111100001000010000100000000000000000000100000000000000000000000000000001
1000000000000100000000000000000001000000000000000000000000000010000100000000000000000000111111111111111111111111111100001
1000000000000100000000000000000001111111111111111111111111111111111100000000000000000000100000000000000000000000000000001
1000000000000100000000000000000001000000000000000000031000000000000000000000000000000000100000000000000000000000000000001
1000000000000100000000000000000001000000000000000000001000000010000000000000000000000000100000000000000000000000000000001
1000000000000100000000000000000001000000000000000000001000000010000000000000000000000000100000000000000000000000000000001
1000000000000100000000000000000001000000011111111111111000000010000000000000000000000000100000000000000000000000000000001
1000000000000000000000000000000001000000000000000001000000000010000000000000000000000000100000000000000000000000000000001
1000000000000000000000000000000001000000000000000001000000000010000000000000000000000000100000000000000000000000000000001
1000000000000000000000000000000001000000000000000001000000000010000000000000000000000000100000000000000000000000000000001
1000000000000000000000000000000001000000000000000001000000000010000000000000000000000000100000000000000000000000000000001
1000000000000000000000000000000001000000000000000000000000000010000000000000000000000000100000000000000000000000000000001
1000000000000000000000000000000001000000000000000001000000000010000000000000000000000000100000000000000000000000000000001
1000000000000000000000000000000001000000000000000001000000000010000000000000000000000000100000000000000000000000000000001
1111111111111111111111111111111111111111111111111111111111111111111111111111111111111111111111111111111111111111111111111